,Show,Gross,Average ticket price,Seats sold,Previews,Regular shows,Total performances
0,'NIGHT MOTHER,2011480,52,38478,26,65,91
1,110 IN THE SHADE,5169314,51,102030,27,94,121
2,13,4436369,59,72907,22,105,127
3,1776,13667789,40,355683,34,333,367
4,1984,6859821,61,112232,38,125,163
5,33 VARIATIONS,4380302,63,70012,31,85,116
6,42ND STREET,133018977,59,2228839,31,1524,1555
7,42ND STREET - ORIGINAL,61642043,0,2116510,0,1920,1920
8,45 SECONDS FROM BROADWAY,3839871,40,95966,31,73,104
9,700 SUNDAYS,32029177,110,287428,28,209,237
10,9 TO 5,15231411,70,218823,23,148,171
11,A BEHANDING IN SPOKANE,7304015,72,102171,20,108,128
12,A BRONX TALE,4888172,66,74433,18,111,129
13,A BRONX TALE THE MUSICAL,68722973,100,682876,28,700,728
14,A CATERED AFFAIR,6453273,67,95542,25,116,141
15,A CHANGE IN THE HEIR,85757,0,8045,16,23,39
16,A CHORUS LINE,54540021,79,681614,18,759,777
17,A Chorus Line - Original,63997588,0,2170823,0,2456,2456
18,A CHRISTMAS CAROL,8605616,62,118494,16,105,121
19,A CHRISTMAS STORY,8633547,94,89233,15,51,66
20,A CLASS ACT,2558362,38,68094,30,105,135
21,A DAY IN THE DEATH OF JOE EGG,2874477,45,63350,24,69,93
22,A DELICATE BALANCE,18418588,69,289168,63,293,356
23,A DOLL'S HOUSE,6495976,45,143989,8,150,158
24,"A DOLL'S HOUSE, PART 2",8304641,62,127990,30,172,202
25,A FEW GOOD MEN,7729208,0,327659,15,497,512
26,A FREE MAN OF COLOR,2827517,50,57542,29,61,90
27,A FUNNY THING HAPPENED ON THE WAY TO THE FORUM,48856284,52,924216,35,715,750
28,A GENTLEMAN'S GUIDE TO LOVE AND MURDER,73749132,97,749169,30,905,935
29,A GRAND NIGHT FOR SINGING,1079709,0,39389,41,52,93
30,A LIFE IN THE THEATRE,2583745,58,45770,24,56,80
31,A LITTLE HOTEL ON THE SIDE,1178462,0,48809,15,41,56
32,A LITTLE LIKE MAGIC,265000,0,21000,11,49,60
33,A LITTLE MORE MAGIC,160000,0,7896,3,19,22
34,A LITTLE NIGHT MUSIC,38606667,104,368614,20,425,445
35,A MAN FOR ALL SEASONS,3612196,56,64431,29,73,102
36,A MIDSUMMER NIGHT'S DREAM,2731254,41,67830,13,65,78
37,A MOM'S LIFE,11623,26,444,0,3,3
38,A MONTH IN THE COUNTRY,1407371,0,38369,24,55,79
39,A MONTH OF SUNDAYS,132421,0,7862,19,4,23
40,A MOON FOR THE MISBEGOTTEN,5912588,76,78866,13,71,84
41,A MOON FOR THE MISBEGOTTEN 2000,5354179,52,102568,15,120,135
42,A NAKED GIRL ON THE APPIAN WAY,3082541,53,57992,27,69,96
43,A NIGHT WITH JANIS JOPLIN,7234546,80,90089,22,140,162
44,A RAISIN IN THE SUN,24194589,103,233479,59,173,232
45,A SMALL FAMILY BUSINESS,1026887,0,46842,30,48,78
46,A SOLDIER'S PLAY,4106326,74,55174,26,55,81
47,A STEADY RAIN,15168742,139,109175,21,80,101
48,A STREETCAR NAMED DESIRE,10139512,58,175558,56,178,234
49,A STREETCAR NAMED DESIRE - 1988,761585,0,47247,21,84,105
50,A STREETCAR NAMED DESIRE - 1992,5947347,0,146568,31,137,168
51,A STREETCAR NAMED DESIRE - 88,761585,0,47247,21,84,105
52,A STREETCAR NAMED DESIRE - 92,5947347,0,146568,31,137,168
53,A TALE OF TWO CITIES,4655502,60,77436,33,60,93
54,A THOUSAND CLOWNS,2658624,46,56664,7,83,90
55,A THOUSAND CLOWNS 1996,1019814,29,34601,38,32,70
56,A TIME TO KILL,1720560,56,32130,23,33,56
57,A TOUCH OF THE POET,3609646,52,69042,32,58,90
58,A TUNA CHRISTMAS,465078,0,13489,8,20,28
59,A VIEW FROM THE BRIDGE,19363208,82,232328,54,196,250
60,A VIEW FROM THE BRIDGE 1997-1998,6475447,35,188903,35,239,274
61,A WALK IN THE WOODS,1562493,0,72519,21,137,158
62,A YEAR WITH FROG AND TOAD,1736421,43,40267,15,73,88
63,ABE LINCOLN IN ILLINOIS,1334845,0,56646,27,40,67
64,ABSURD PERSON SINGULAR,1816196,49,37235,29,56,85
65,ACCENT ON YOUTH,2028775,49,41751,24,71,95
66,ACCIDENTAL DEATH ANAR.,312887,0,22763,15,20,35
67,ACCOMPLICE,935345,0,66323,23,52,75
68,ACT ONE,4761068,65,72546,31,67,98
69,AFTER MIDNIGHT,21234352,87,244603,18,273,291
70,AFTER MISS JULIE,2534646,46,54538,40,53,93
71,AFTER THE FALL,2998486,52,57353,40,53,93
72,AFTER THE NIGHT AND THE MUSIC,1558313,47,33008,39,38,77
73,AH WILDERNESS,1721052,26,66008,30,54,84
74,AH WILDERNESS! - LONG DAY'S JOURNEY INTO NIGHT,803598,0,31422,8,40,48
75,AIDA,165928398,61,2714193,30,1852,1882
76,AIN'T BROADWAY GRAND,865780,0,30807,27,25,52
77,AIN'T MISBEHAVIN',5332871,0,159433,8,176,184
78,AIN'T TOO PROUD,84225732,124,663794,21,485,506
79,AIRLINE HIGHWAY,1521105,42,36708,25,53,78
80,ALL ABOUT ME,1354494,52,26494,27,20,47
81,ALL MY SONS,17251132,89,195889,51,181,232
82,ALL MY SONS 1987,207092,0,12376,5,31,36
83,ALL SHOOK UP,14447491,49,298652,33,213,246
84,ALL THE WAY,19492726,109,177511,27,129,156
85,ALLEGIANCE,8614614,76,113152,37,111,148
86,ALONE TOGETHER,1135019,0,55617,15,97,112
87,ALTON BROWN LIVE: EAT YOUR SCIENCE,580738,103,5651,0,8,8
88,AMADEUS,5242594,43,121632,10,173,183
89,AMAZING GRACE,5540127,60,92670,24,116,140
90,AMÃ‰LIE,5307176,82,64833,27,56,83
91,AMERICAN IDIOT,39798052,77,510723,26,422,448
92,AMERICAN PSYCHO,5627480,78,72358,27,54,81
93,AMERICAN SON,9811233,117,84436,33,97,130
94,AMERICAN UTOPIA,40649176,138,295895,41,240,281
95,AMOUR,1338399,46,29103,31,17,48
96,AMY'S VIEW,5911176,50,117926,12,103,115
97,AN ACT OF GOD,15649525,100,147895,34,174,208
98,AN ALMOST HOLY PICTURE,2534937,45,56198,19,69,88
99,AN AMERICAN DAUGHTER,2712516,30,93476,27,89,116
100,AN AMERICAN IN PARIS,85539240,96,882254,29,623,652
101,AN ENEMY OF THE PEOPLE,1967382,47,41886,26,59,85
102,AN EVENING WITH JERRY HERMAN,365391,34,11345,13,28,41
103,AN EVENING WITH PATTI LUPONE AND MANDY PATINKIN,3740974,90,41613,6,57,63
104,AN IDEAL HUSBAND,7755341,35,220920,7,307,314
105,AN INSPECTOR CALLS,14597764,0,347361,13,454,467
106,ANASTASIA,93439880,105,881733,34,808,842
107,ANGELS IN AMERICA,40937028,20,658578,72,697,769
108,ANN,5251537,63,84060,19,132,151
109,ANNA CHRISTIE,1138978,0,37992,24,53,77
110,ANNA IN THE TROPICS,3115592,46,67446,15,113,128
111,ANNA KARENINA,569861,0,31895,18,46,64
112,ANNIE,59051957,86,677853,38,487,525
113,ANNIE - 1997,12836836,51,253160,14,239,253
114,ANNIE GET YOUR GUN,82148713,58,1415850,35,1045,1080
115,ANY GIVEN DAY,420620,0,24691,16,32,48
116,ANYTHING GOES,47288859,91,515954,32,521,553
117,ANYTHING GOES 1987-1989,30293686,0,815629,44,784,828
118,ARCADIA,4881785,63,78061,20,108,128
119,Arcadia 1995,5818602,0,174341,31,173,204
120,AREN'T WE ALL,3208200,0,98681,19,93,112
121,ARMS AND THE MAN,1231248,0,65324,23,109,132
122,ARSENIC AND OLD LACE,3860980,0,204249,7,221,228
123,ART,24287247,45,529168,20,600,620
124,ARTIST DESCENDING A STAIRCASE,478626,0,16636,11,36,47
125,AS IS,2384737,0,133617,6,286,292
126,AS LONG AS WE BOTH SHALL LAUGH,330477,24,14257,9,15,24
127,ASINAMALI,132801,0,9007,11,28,39
128,ASPECTS OF LOVE,16026804,0,369318,22,377,399
129,ASSASSINS,6024383,57,106080,26,101,127
130,AUGUST: OSAGE COUNTY,32835606,70,463842,18,648,666
131,AVENUE Q,121918918,70,1731068,22,2534,2556
132,AWAKE AND SING!,3384141,45,74205,27,80,107
133,AZNAVOUR,1331285,54,24766,1,23,24
134,BABY,453966,0,17214,0,32,32
135,BABY IT'S YOU!,9111694,57,159952,33,148,181
136,BAND IN BERLIN,383380,37,10438,19,17,36
137,BANDSTAND,13487288,83,162335,24,166,190
138,BARBARA COOK,187402,0,8311,13,13,26
139,BARBARA COOK: MOSTLY SONDHEIM,1202305,43,28176,5,26,31
140,BARBARA COOK'S BROADWAY,438437,43,10298,5,7,12
141,BAREFOOT IN THE PARK,4501355,54,82769,26,109,135
142,BARRY MANILOW,3466049,161,21647,0,17,17
143,BARRYMORE,6566575,38,174965,12,236,248
144,BE MORE CHILL,14217792,93,151941,30,177,207
145,BEA ARTHUR ON BROADWAY,1715877,46,37143,23,65,88
146,BEAUTIFUL,270497162,117,2290224,60,2416,2476
147,BEAUTY AND THE BEAST,429158458,50,7609397,46,5461,5507
148,BELLS ARE RINGING,3527176,50,71017,36,68,104
149,BENEFACTORS,4572197,0,161517,12,217,229
150,BENGAL TIGER AT THE BAGDHAD ZOO,7889821,82,97721,23,108,131
151,BERNHARDT/HAMLET,3886235,71,54742,26,63,89
152,BETRAYAL,32621468,98,305392,79,281,360
153,BIG,9736877,42,229895,22,193,215
154,BIG DEAL,2270309,0,65947,8,69,77
155,BIG FISH,10858194,74,146730,34,98,132
156,BIG RIVER,2802669,47,60161,28,67,95
157,BILL MAHER: VICTORY BEGINS AT HOME,533861,43,12034,8,16,24
158,BILLY ELLIOT: THE MUSICAL,183514398,102,1787108,40,1312,1352
159,BILOXI BLUES,13751235,0,519664,12,524,536
160,BLACK AND BLUE,33601122,0,934331,32,829,861
161,BLACK COMEDY/WHITE LIARS,650934,0,26256,25,38,63
162,BLACK TO THE FUTURE,905893,98,9178,0,6,6
163,BLACKBIRD,7855675,74,107039,37,108,145
164,BLAST!,8169127,40,203655,13,180,193
165,BLITHE SPIRIT,11603724,71,162121,20,145,165
166,BLITHE SPIRIT 1987,3248399,0,115210,24,104,128
167,BLOOD BROTHERS,20752831,0,555459,13,840,853
168,BLOOD KNOT,845464,0,47366,13,95,108
169,BLOODY BLOODY ANDREW JACKSON,5629559,61,91636,26,94,120
170,BOBBI BOLAND,100389,39,2570,7,0,7
171,BOEING-BOEING,13951563,61,227265,17,279,296
172,BOMBAY DREAMS,22437579,61,366843,30,284,314
173,BONNIE AND CLYDE,3277347,59,56138,33,36,69
174,BORN YESTERDAY,2792677,49,58288,28,73,101
175,BORN YESTERDAY 1989,3093950,0,125354,13,153,166
176,BOYS CHOIR OF HARLEM AND FRIENDS,182631,0,7327,4,14,18
177,BOYS IN AUTUMN,440271,0,27040,21,70,91
178,BOYS OF WINTER,237741,0,11420,31,9,40
179,BREAKFAST AT TIFFANY'S,2475937,66,37872,17,38,55
180,BREAKING THE CODE,4186299,0,164051,9,169,178
181,BRIDGE AND TUNNEL,6135555,60,102454,16,213,229
182,BRIEF ENCOUNTER,5210372,55,94033,21,111,132
183,BRIGHT STAR,7474494,67,111483,30,109,139
184,BRIGHTON BEACH MEMOIRS,539369,26,21631,25,9,34
185,BRIGHTON BEACH MEMOIRS 1984-1986,11823976,0,605927,0,808,808
186,BRING IN DA NOISE BRING IN DA FUNK,54448939,48,1118863,15,1135,1150
187,BRING IT ON THE MUSICAL,11410177,63,180680,21,171,192
188,BROADWAY,43747,0,3071,3,4,7
189,BROADWAY BOUND,15991551,0,612247,12,756,768
190,BROKEN GLASS,1393461,0,49960,15,73,88
191,BRONX BOMBERS,1212059,44,29511,31,29,60
192,BROOKLYN,10108600,51,196826,27,284,311
193,BROOKLYN BOY,2135668,49,43367,23,62,85
194,BUDDY,7085959,0,206332,15,225,240
195,BULLETS OVER BROADWAY,18176367,80,226497,33,156,189
196,BURIED CHILD,1361820,23,59056,14,72,86
197,BURN THE FLOOR,9285678,63,145582,8,185,193
198,BURN THIS,19923583,28,420185,40,539,579
199,BUS STOP,650106,21,31842,21,29,50
200,BUTLEY,5424237,73,74286,21,94,115
201,BUTTONS ON BROADWAY,364581,0,16924,3,33,36
202,BY JEEVES,2090954,59,35902,15,73,88
203,BYE BYE BIRDIE,11485459,75,152597,40,117,157
204,CABARET,160539464,70,2267052,72,2765,2837
205,CABARET 1987-1988,10220724,0,292878,18,261,279
206,CAFE CROWN,392105,0,28930,0,42,42
207,CAMELOT,3714457,0,75937,4,56,60
208,CANCIONES DE MI PADRE,635122,0,16880,0,17,17
209,CANDIDA,762375,0,28448,24,45,69
210,CANDIDE,5065916,34,146016,10,104,114
211,CARETAKER,385496,0,24335,23,45,68
212,"CAROLINE, OR CHANGE",5607244,76,73523,17,85,102
213,CAROUSEL,46906773,38,648453,85,518,603
214,CARRIE,341396,0,17752,16,5,21
215,CASA VALENTINA,3028464,56,54116,24,79,103
216,CAT ON A HOT TIN ROOF,24264540,86,282403,61,209,270
217,CAT ON A HOT TIN ROOF 2003-2004,8898242,71,124967,28,145,173
218,CATCH ME IF YOU CAN,16863570,70,242671,32,166,198
219,CATS,432003657,20,9333667,16,7385,7401
220,CATSKILLS ON BROADWAY,10354113,0,349212,19,453,472
221,CELEBRITY AUTOBIOGRAPHY,223394,54,4124,0,3,3
222,CHAPLIN,8518390,72,118148,24,135,159
223,CHARLIE AND THE CHOCOLATE FACTORY,43679424,100,436089,27,305,332
224,CHECKMATES,2396727,0,125264,16,172,188
225,CHESS,3806343,0,100726,17,68,85
226,CHICKEN & BISCUITS,1291806,45,31232,18,41,59
227,CHILDREN OF A LESSER GOD,3424264,55,62561,23,54,77
228,CHINA DOLL,12630662,143,86727,40,54,94
229,CHINESE COFFEE/SALOME,1395575,0,33793,29,30,59
230,CHINGLISH,4325401,61,72385,19,109,128
231,CHITA RIVERA: THE DANCER'S LIFE,3563420,62,57822,20,72,92
232,CHITTY CHITTY BANG BANG,27509505,64,426915,34,285,319
233,CHOIR BOY,3854430,66,57759,31,72,103
234,CHRONICLE OF A DEATH FORETOLD,1031381,0,48258,28,37,65
235,CHU CHEM,381039,0,24176,0,68,68
236,CINDERELLA,88166620,84,1039923,41,769,810
237,CIRQUE DREAMS: JUNGLE FANTASY,5166140,56,92789,10,70,80
238,CITY OF ANGELS,45328992,0,1013486,24,879,903
239,CLOSER,5318897,40,131326,17,172,189
240,CLYBOURNE PARK,8767402,66,133198,27,157,184
241,CLYDE'S,2099849,60,34848,24,62,86
242,COASTAL DISTURBANCES,2440201,0,141800,20,350,370
243,COLIN QUINN - AN IRISH WAKE,241753,37,6542,2,22,24
244,COLIN QUINN: LONG STORY SHORT,3075662,58,53090,21,135,156
245,COLLECTED STORIES,1348639,42,32239,22,54,76
246,COME BACK LITTLE SHEBA,2052427,54,37416,27,58,85
247,COME FLY AWAY,18368158,85,218299,26,188,214
248,COMEDY TONIGHT,134514,0,11981,5,9,14
249,COMPANY - Original,2532590,4,55352,43,60,103
250,CONSTELLATIONS,6642180,99,66543,29,76,105
251,CONTACT,60218526,64,931293,31,1010,1041
252,CONVERSATIONS WITH MY FATHER,10168415,0,334950,30,402,432
253,COPENHAGEN,11570839,44,263203,21,326,347
254,CORAM BOY,1602370,49,33065,17,30,47
255,CORPSE,686380,0,14293,28,121,149
256,CRAZY FOR YOU,92554871,1,2090822,26,1622,1648
257,CRAZY HE CALLS ME,143880,0,11084,16,7,23
258,CRISS ANGEL,434072,49,8794,0,7,7
259,CRY BABY,4077104,34,120932,45,68,113
260,CUBA TEDDY BEAR,1503086,0,57994,0,53,53
261,CURTAINS,43628368,75,582455,26,511,537
262,CYMBELINE,2080001,51,41739,34,40,74
263,CYRANO,4135600,0,125574,38,137,175
264,CYRANO DE BERGERAC,10467439,69,139229,53,108,161
265,DAME EDNA: BACK WITH A VENGEANCE,7021853,63,110199,17,163,180
266,DAME EDNA: THE ROYAL TOUR,9815693,48,203582,39,297,336
267,DAMES AT SEA,2540354,57,45367,32,85,117
268,DAMN YANKEES,27913661,0,657446,18,534,552
269,DANA H.,835529,48,16434,10,25,35
270,DANCE OF DEATH,5426431,50,108898,27,108,135
271,DANCE OF THE VAMPIRES,9431254,61,156118,61,56,117
272,DANCING AT LUGHNASA,10017136,0,314779,15,421,436
273,DANCING INTHE END ZONE,113224,0,7958,15,28,43
274,DANGEROUS GAMES,142550,0,9566,12,4,16
275,DANNY GANS ON BROADWAY,84362,0,8271,11,6,17
276,DAVE CHAPPELLE,3069512,212,14913,0,10,10
277,DEAD ACCOUNTS,3089827,79,39768,27,44,71
278,DEATH AND THE MAIDEN,7232393,0,190203,33,159,192
279,DEATH OF A SALESMAN,12868982,116,110550,30,78,108
280,DEATH OF A SALESMAN 1984,3681507,0,102821,0,88,88
281,DEATHANDKING'S HORSEMAN,474221,0,34521,19,33,52
282,DEF POETRY JAM,3377597,33,99641,17,198,215
283,DEFENDING THE CAVEMAN,11720395,25,320334,25,674,699
284,DEMOCRACY,7091677,56,124982,17,173,190
285,DERREN BROWN: SECRET,7258069,82,88119,10,113,123
286,DESIGN FOR LIVING,2984209,49,60606,30,69,99
287,DESIGN FOR LIVING 1985,2142794,0,107881,17,245,262
288,DESIRE UNDER THE ELMS,1381950,52,26397,16,32,48
289,DEUCE,5361739,60,86895,27,121,148
290,DIANA,376471,69,5448,6,0,6
291,"DIANA, THE MUSICAL",2467119,75,34370,16,34,50
292,DINNER AT EIGHT,2606844,42,61990,28,45,73
293,DIRTY BLONDE,7925422,48,163977,20,352,372
294,DIRTY ROTTEN SCOUNDRELS,58033865,71,808025,36,627,663
295,DISASTER!,4293431,61,70701,32,72,104
296,DISGRACED,8534968,74,114762,27,149,176
297,DIVIDING THE ESTATE,2796827,54,51037,31,50,81
298,DOCTOR ZHIVAGO,3197457,60,54370,26,23,49
299,DON'T DRESS FOR DINNER,2130070,44,48420,32,61,93
300,DON'T GET GOD STARTED,1865671,0,72528,18,85,103
301,DONNY AND MARIE: A BROADWAY CHRISTMAS,2843463,112,24979,0,20,20
302,DOUBLES,2342901,0,122866,10,277,287
303,DOUBT,27656473,67,406085,25,525,550
304,DR. SEUSS' HOW THE GRINCH STOLE CHRISTMAS!,22903349,68,322903,35,203,238
305,DRACULA THE MUSICAL,6109526,58,106028,22,157,179
306,DREAM: THE JOHNNY MERCER MUSICAL,3311853,39,84598,24,109,133
307,DREAMGIRLS,4492189,0,154504,7,177,184
308,DREAMGIRLS 1984-1985,15471737,0,545965,0,496,496
309,DREAMS AND NIGHTMARES,6033691,60,100217,21,55,76
310,DRIVING MISS DAISY,13586627,102,131694,20,180,200
311,DROOD,20993477,0,665094,24,608,632
312,DROWNING CROW,1619255,48,33799,23,54,77
313,EASTERN STANDARD,1197966,0,51347,20,92,112
314,ECLIPSED,5744145,74,77911,14,121,135
315,ELAINE STRITCH AT LIBERTY,5000248,59,84481,11,69,80
316,ELECTRA,4629683,42,108893,15,116,131
317,ELF,17898004,104,168122,7,131,138
318,ELF-THE MUSICAL,594759,65,9190,8,0,8
319,ELLING,686837,35,20665,22,9,31
320,ENCHANTED APRIL,3492109,41,85013,24,143,167
321,END OF THE RAINBOW,6856068,69,99053,16,160,176
322,ENRON,1489074,55,27431,22,16,38
323,EPIC PROPORTIONS,1317751,36,36214,27,93,120
324,EQUUS,11962267,86,140597,21,156,177
325,ESCAPE TO MARGARITAVILLE,12444604,83,153544,29,124,153
326,EUGENE ONEGIN,97542,0,4047,0,7,7
327,EVERYDAY RAPTURE,2358299,45,53366,11,85,96
328,EVITA,52678175,110,474853,26,337,363
329,EXECUTION OF JUSTICE,93247,0,7053,8,12,20
330,EXIT THE KING,6703380,69,96429,21,93,114
331,FACE VALUE,50114,0,2816,8,0,8
332,FAITH HEALER,7583448,76,99297,19,117,136
333,FALSETTOS,19931243,16,387283,53,570,623
334,FARINELLI AND THE KING,12193852,103,118919,14,111,125
335,FELA!,33452773,73,457401,38,491,529
336,FENCES,12908907,117,110215,13,88,101
337,FENCES 1987-1988,13796739,0,533252,11,525,536
338,FESTEN,1853946,53,35065,20,49,69
339,FIDDLER ON THE ROOF,107360337,69,1528524,70,1212,1282
340,FIDDLER ON THE ROOF 90-91,13629209,0,331803,18,241,259
341,FINDING NEVERLAND,64214541,88,723370,33,565,598
342,FINIAN'S RAINBOW,7888826,60,132659,22,92,114
343,FIRST DATE,10018641,63,159061,34,174,208
344,FISH IN THE DARK,27652896,126,218241,33,173,206
345,FLAMENCO PURO,1431495,0,47604,3,53,56
346,FLOWER DRUM SONG,11264444,64,173290,25,169,194
347,FLYING OVER SUNSET,2274957,57,40067,36,35,71
348,FOLLIES,19566692,92,216360,38,152,190
349,FOLLIES 2001,7080718,55,128928,31,117,148
350,FOOL FOR LOVE,3721858,71,52876,25,75,100
351,FOOL MOON,1686553,38,44657,7,49,56
352,FOOL MOON 1993,5666265,0,202319,13,215,228
353,FOOL MOON 1995-1996,2483746,19,69351,10,81,91
354,FOOTLOOSE,37134917,47,780117,18,709,727
355,FOREVER TANGO,5518980,56,97257,13,187,200
356,Forever Tango 1997-1998,13872413,40,350842,4,458,462
357,FORTUNE'S FOOL,4318899,44,98735,28,127,155
358,FOSSE,68997054,61,1121921,21,1093,1114
359,FOUR BABOONS ADORING,811304,0,45151,26,38,64
360,FRANKIE AND JOHNNY IN THE CLAIR DE LUNE,3548264,64,57997,26,69,95
361,FRANKIE AND JOHNNY IN THE CLAIRE DE LUNE,11458493,56,195423,15,243,258
362,FRANKIE VALLI AND THE FOUR SEASONS ON BROADWAY,2671259,128,21090,0,14,14
363,FREAK,5283095,34,158015,23,144,167
364,FREESTYLE LOVE SUPREME,17714172,114,152071,37,201,238
365,FROST/NIXON,9395227,65,141445,23,137,160
366,FROZEN,155193554,114,1359038,26,822,848
367,FROZEN 2004,2252052,41,55085,6,128,134
368,FULLY COMMITTED,7068657,76,93227,28,112,140
369,FUN HOME,41520587,98,416083,26,583,609
370,GARDEN DISTRICT,510674,0,23007,19,31,50
371,GARY: A SEQUEL TO TITUS ANDRONICUS,4503831,58,76853,45,65,110
372,GEM OF THE OCEAN,2577530,47,54245,15,72,87
373,GENTLEMEN PREFER BLONDES,579727,0,19399,16,24,40
374,GEORGE GERSHWIN ALONE,1055351,39,27495,16,96,112
375,GETTIN' THE BAND BACK TOGETHER,2045986,42,49295,30,40,70
376,GETTING AND SPENDING,484281,35,14353,23,41,64
377,GETTING AWAY WITH MURDER,1254380,33,37811,29,17,46
378,GETTING MARRIED,794982,0,49295,22,70,92
379,GHETTO,308308,0,18118,25,33,58
380,GHETTO KLOWN,6179540,73,84440,25,95,120
381,GHOST,13339472,72,186851,39,136,175
382,GIGI,7028015,73,96860,20,86,106
383,GLENGARRY GLEN ROSS,22834337,97,231832,75,182,257
384,GLENGARRY GLEN ROSS 1984-1985,3558883,0,201282,0,296,296
385,GLORY DAYS,111283,39,3719,17,1,18
386,GOD OF CARNAGE,37345584,86,414191,24,452,476
387,"GOD SAID ""HA""",286310,25,11388,11,22,33
388,GODSPELL,11106035,69,160892,30,264,294
389,GOLDA'S BALCONY,9309657,50,180557,14,493,507
390,GOLDEN BOY,3106647,56,54318,30,53,83
391,GOLDEN CHILD,828439,24,34346,11,69,80
392,GOOD PEOPLE,5925428,73,81075,27,101,128
393,GORE VIDAL'S THE BEST MAN,24328421,81,298174,46,306,352
394,GRACE,6479055,76,85684,22,108,130
395,GRAND HORIZONS,2259619,58,38572,35,45,80
396,GRAND HOTEL,43084265,0,1120499,31,1017,1048
397,GRAY'S ANATOMY,459423,0,25349,5,21,26
398,GREASE,47473854,86,551325,31,554,585
399,GREY GARDENS,17542980,75,234344,32,308,340
400,GRIND,2369009,0,79934,25,71,96
401,GROUNDHOG DAY,19585335,90,217221,31,176,207
402,GUYS AND DOLLS,10220561,67,152117,28,121,149
403,GUYS AND DOLLS 1992-1995,65388544,0,1282292,33,1143,1176
404,GYPSY,31430300,71,441949,27,332,359
405,GYPSY 1989-1991,29497916,0,765365,35,581,616
406,GYPSY 2003-2004,37762532,68,549037,33,451,484
407,GYPSY PASSION,614574,0,23042,0,55,55
408,HAIR,54024621,77,682727,40,586,626
409,HAIRSPRAY,252181270,73,3418653,31,2642,2673
410,HAMLET 1992,665378,0,28273,26,45,71
411,HAMLET 1995,5094936,0,105388,19,91,110
412,HAMLET 2009,10010252,101,99759,25,72,97
413,HAND TO GOD,12134434,70,173143,26,311,337
414,HANDS ON A HARDBODY,1597428,40,41856,28,28,56
415,HARRIGAN 'N HART,288674,0,15114,25,4,29
416,HARRY CONNICK JR.,2620770,127,20625,0,15,15
417,Harry Connick Jr. 1990,630158,0,19628,0,13,13
418,"HARRY CONNICK, JR. - A CELEBRATION OF COLE PORTER",4434144,163,28568,5,21,26
419,"HARRY POTTER AND THE CURSED CHILD, PARTS ONE AND TWO",174056581,132,1324815,34,783,817
420,HARVEY,6802810,72,93579,32,62,94
421,HAVING OUR SAY,5342140,4,179225,24,317,341
422,HAY FEVER,1622144,0,74796,16,124,140
423,HEAD OVER HEELS,7107981,61,121187,37,188,225
424,HEARTBREAK HOUSE,3177764,47,67971,30,79,109
425,HEDDA GABLER 1994,868966,0,30070,37,33,70
426,HEDDA GABLER 2001-2002,3297340,40,83031,17,117,134
427,HEDDA GABLER 2009,2742238,49,56067,21,74,95
428,HEDWIG AND THE ANGRY INCH,50259435,107,459696,22,507,529
429,HEISENBERG,4516447,78,57555,26,67,93
430,HELLO DOLLY!,6459815,26,144729,11,116,127
431,"HELLO, DOLLY!",128198738,156,811203,34,550,584
432,HENRY IV,4870242,62,77060,20,58,78
433,HIGH,449955,26,18112,29,7,36
434,HIGH FIDELITY,1096116,55,20022,19,13,32
435,HIGH SOCIETY,7317557,43,168193,27,144,171
436,HILLARY AND CLINTON,5240468,66,79786,37,77,114
437,HIZZONER,137324,0,8752,12,12,24
438,HOLIDAY,741050,17,30364,17,50,67
439,HOLIDAY INN,10143052,80,124170,38,117,155
440,HOLLER IF YA HEAR ME,1209478,34,37161,17,38,55
441,HOLLYWOOD ARMS,2043835,44,47006,28,76,104
442,HOME FOR THE HOLIDAYS,481817,24,20609,6,47,53
443,HOME FRONT,156133,0,9180,11,13,24
444,HONEYMOON IN VEGAS,7609536,66,117945,66,93,159
445,HONKY TONK NIGHTS,78865,0,6122,14,4,18
446,HONOUR,1132819,28,41160,27,57,84
447,HOT FEET,3766746,49,76824,12,97,109
448,HOUSE OF BLUE LEAVES,5700561,0,272340,0,352,352
449,HOW TO SUCCEED IN BUSINESS WITHOUT REALLY TRYING,59740764,94,628957,30,473,503
450,HOW TO SUCCEED IN BUSINESS WITHOUT REALLY TRYING 95/96,29473664,20,629821,16,548,564
451,HUGH JACKMAN - BACK ON BROADWAY,14634985,156,93407,18,61,79
452,HUGHIE,4697236,55,83562,46,93,139
453,HURLYBURLY,6766948,0,250730,0,343,343
454,I AM MY OWN WIFE,8648562,49,176011,26,360,386
455,I HATE HAMLET,1373609,0,73124,24,88,112
456,I'LL EAT YOU LAST: A CHAT WITH SUE MENGERS,9561477,137,69337,18,71,89
457,I'M NOT RAPPAPORT,793377,37,21365,15,53,68
458,I'm Not Rappaport 1985-1988,14858286,0,571321,0,891,891
459,I'M STILL HERE...DAMN IT!,1228086,38,32876,12,51,63
460,IAN MCKELLAN: KNIGHTOUT,192571,0,3794,0,5,5
461,ICEMAN COMETH,1505587,0,58553,7,55,62
462,IF YOU EVER LEAVE MEâ€¦I'M GOING WITH YOU,1361049,37,36852,24,53,77
463,IF/THEN,39635141,87,453766,29,401,430
464,IL DIVO - A MUSICAL AFFAIR,1308223,142,9241,0,6,6
465,IMAGINARY FRIENDS,2857950,57,50516,20,76,96
466,IMPRESSIONISM,2776558,64,44558,23,56,79
467,IN MY LIFE,1557164,48,32307,23,61,84
468,IN THE HEIGHTS,105302946,79,1322889,29,1184,1213
469,IN THE NEXT ROOM OR THE VIBRATOR PLAY,2129999,45,47282,31,60,91
470,IN THE SUMMER HOUSE,713179,0,43370,28,25,53
471,IN TRANSIT,6075958,61,98204,36,145,181
472,INDECENT,6159154,57,104281,15,128,143
473,INDISCRETIONS,6989870,0,182878,28,220,248
474,INHERIT THE WIND,6411103,68,93909,19,100,119
475,INHERIT THE WIND 1996,2883421,44,65270,42,45,87
476,INK,5289107,88,60205,24,87,111
477,INTO THE LIGHT,91153,0,5969,13,6,19
478,INTO THE WOODS,14731618,63,233472,18,279,297
479,INTO THE WOODS 1987-1989,29851411,0,844043,43,765,808
480,IRENA'S VOW,3070112,48,64931,23,105,128
481,IRVING BERLIN'S WHITE CHRISTMAS,759048,82,9224,0,7,7
482,IRVING BERLIN'S WHITE CHRISTMAS 2008-2009,15467881,98,154130,25,97,122
483,IS HE DEAD?,2882050,49,58357,13,105,118
484,IS THIS A ROOM,1016193,50,18840,11,26,37
485,IT AIN'T NOTHIN' BUT THE BLUES,6752894,40,170092,5,284,289
486,IT SHOULDA BEEN YOU,7881052,64,122504,31,135,166
487,IT'S A SLIPPERY SLOPE,410047,23,18091,2,17,19
488,IT'S ONLY A PLAY,37500966,123,293622,48,274,322
489,IVANOV,2953109,36,83270,31,51,82
490,JACK: A NIGHT ON THE TOWN WITH JOHN BARRYMORE,73498,21,3513,4,12,16
491,JACKIE MASON: BRAND NEW,4756677,0,256957,6,216,222
492,JACKIE MASON: FRESHLY SQUEEZED,2964688,56,53002,14,172,186
493,JACKIE MASON: POLITICALLY INCORRECT,5061323,0,154724,13,348,361
494,JACKIE MASON: MUCH ADO ABOUT EVERYTHING,5303427,47,112483,33,186,219
495,JACKIE MASON'S LAUGHING ROOM ONLY,1015629,49,21844,31,14,45
496,JACKIE: AN AMERICAN LIFE,2261732,33,69868,34,128,162
497,JAGGED LITTLE PILL,24322715,114,215062,36,168,204
498,JAKE'S WOMEN,7675249,0,256752,14,245,259
499,JAMES JOYCE'S THE DEAD,4376057,48,91086,24,120,144
500,JANE EYRE,8083185,48,168879,36,209,245
501,JAY JOHNSON: THE TWO AND ONLY,587011,48,12107,10,70,80
502,JEKYLL & HYDE,2470240,65,39385,15,30,45
503,JEKYLL AND HYDE,78056883,56,1403224,45,1543,1588
504,JELLY'S LAST JAM,31571770,0,666946,25,569,594
505,JEROME KERN HOLLYWOOD,122449,0,8015,9,13,22
506,JEROME ROBBINS' BROADWAY,40683240,0,910410,55,633,688
507,JERRY SEINFELD,774652,70,11060,0,10,10
508,JERRY'S GIRLS,3077118,0,122060,14,141,155
509,JERSEY BOYS,558416092,107,5150298,38,4642,4680
510,JERUSALEM,8004618,67,118970,21,141,162
511,JESUS CHRIST SUPERSTAR,10882991,78,141223,24,116,140
512,JESUS CHRIST SUPERSTAR 2000,11284435,45,250225,28,161,189
513,JITNEY,3598741,68,52176,21,62,83
514,JOE EGG,916650,0,50929,8,93,101
515,JOE TURNER'S COME AND GONE,3022226,45,66014,31,69,100
516,JOE TURNER'S COME AND GONE 1988,1278722,0,64709,11,105,116
517,JOHN LITHGOW: STORIES BY HEART,3971203,73,54139,21,61,82
518,JOSEPH AND THE AMAZING TECHNICOLOR DREAMCOAT,14280712,0,295962,17,231,248
519,JOURNEY'S END,2514849,48,53094,15,125,140
520,JUAN DARIEN,1187129,27,44121,20,49,69
521,JUDGMENT AT NUREMBERG,2025590,35,57914,45,56,101
522,JULIUS CAESAR,8543103,83,102854,31,81,112
523,JUMPERS,3957158,50,78865,23,89,112
524,JUNK,6583820,77,85734,30,77,107
525,JUNO AND THE PAYCOCK,312358,0,11723,6,12,18
526,KAT AND THE KINGS,3418286,36,94995,15,157,172
527,KATHY GRIFFIN WANTS A TONY,1021880,106,9934,0,10,10
528,KIKI AND HERB: ALIVE ON BROADWAY,619680,64,9520,5,27,32
529,KING CHARLES III,9411612,96,98107,22,103,125
530,KING DAVID,677313,53,12745,3,6,9
531,KING HEDLEY II,2479599,36,68803,24,72,96
532,KING KONG,36707905,79,464288,29,322,351
533,KING LEAR,9978653,72,136338,50,109,159
534,KINKY BOOTS,318990092,105,2980822,34,2505,2539
535,KIPLING,82583,0,4842,5,12,17
536,KISS ME KATE,65051743,61,1056908,28,882,910
537,"KISS ME, KATE",14272788,95,149856,30,125,155
538,KISS OF THE SPIDER WOMAN,42138889,0,863221,16,904,920
539,KRISTIN CHENOWETH: FOR THE GIRLS,969894,101,9584,0,8,8
540,LA BETE,4382858,61,73042,24,101,125
541,LA BOHÃˆME,20773921,73,284906,12,228,240
542,LA CAGE AUX FOLLES - Original,64214287,0,1948853,0,1440,1440
543,LA CAGE AUX FOLLES 1984-1987,64214287,0,1948853,0,1440,1440
544,LA CAGE AUX FOLLES 2004-2005,16381491,59,275385,34,226,260
545,LA CAGE AUX FOLLES 2010-2011,29057813,83,347661,15,433,448
546,LACKAWANNA BLUES,1033336,51,20060,18,27,45
547,LADY DAY AT EMERSON'S BAR & GRILL,14085440,113,124376,20,173,193
548,LARGELY NEW YORK,2300823,0,121825,11,144,155
549,LATE NITE COMIC,97657,0,8456,15,4,19
550,LATIN HISTORY FOR MORONS,9504510,94,101009,20,104,124
551,LATINOLOGUES,1104272,43,26013,34,93,127
552,LAUGH WHORE,1828501,46,39329,13,66,79
553,LAUGHTER ON THE 23RD FLOOR,8326356,0,274611,24,320,344
554,LEADER OF THE PACK,2739475,0,111515,53,120,173
555,LEAP OF FAITH,1343840,27,50021,25,19,44
556,LEGALLY BLONDE,56338126,69,814072,30,595,625
557,LEGS DIAMOND,5907024,0,138098,72,64,136
558,LEND ME A TENOR,16659783,18,478760,41,629,670
559,LENNON,3596685,66,54449,42,49,91
560,LES LIAISONS DANGEREUSES,9939835,79,127449,46,158,204
561,LES LIAISONS DANGEREUSES 1987,3910600,0,137581,8,149,157
562,LES MISÃ‰RABLES,143676240,85,1675778,39,1487,1526
563,LES MISÃ‰RABLES - ORIGINAL,406258901,23,8925169,11,6680,6691
564,LESTAT,4630419,59,80434,32,40,72
565,LET IT BE,2535797,54,48350,10,46,56
566,LETTICE AND LOVAGE,10945657,0,313850,15,286,301
567,LIFE x 3,4570880,58,79272,21,104,125
568,LILLIAN,279551,0,14224,5,45,50
569,LINDA VISTA,1605102,56,29034,25,37,62
570,LITTLE ME,3266231,51,64069,43,99,142
571,LITTLE SHOP OF HORRORS,20607589,59,350389,40,372,412
572,LITTLE WOMEN,9793281,64,153439,55,137,192
573,LIVING ON LOVE,811148,30,27322,21,16,37
574,LIZA'S AT THE PALACE,3059851,101,31431,0,22,22
575,LOBBY HERO,4795126,100,47672,30,56,86
576,LOMBARDI,9313391,63,147379,31,244,275
577,LONDON ASSURANCE,1493967,37,39976,14,72,86
578,LONG DAY'S JOURNEY,1139393,0,43159,6,54,60
579,LONG DAY'S JOURNEY INTO NIGHT,16487095,86,190648,33,178,211
580,LOOPED,1262525,41,31207,27,33,60
581,LOOT,1075400,0,52590,5,96,101
582,LORD OF THE DANCE: DANGEROUS GAMES,3616869,61,58276,4,67,71
583,LOSING LOUIE,1548011,50,30824,24,53,77
584,LOST IN YONKERS,23275602,0,772566,11,780,791
585,LOVE / LIFE,280480,41,6914,0,8,8
586,LOVE LETTERS,4762317,36,85227,6,191,197
587,LOVE THY NEIGHBOR,3856374,36,106652,5,234,239
588,LOVE! VALOUR! COMPASSION!,5849633,0,179722,28,248,276
589,LOVEMUSIK,2494723,60,41203,24,60,84
590,LOVES OF ANATOL,405843,0,23388,15,46,61
591,LUCIFER'S CHILD,259185,0,11635,6,28,34
592,LUCKY GUY,22992145,141,163710,33,104,137
593,LYSISTRATA JONES,1391172,36,39217,34,30,64
594,M. BUTTERFLY,5248147,88,60311,19,61,80
595,MA RAINEY'S BLACK BOTTOM,2427214,52,45737,14,68,82
596,MA RAINEY'S BLACK BOTTOM 1984-1985,2619607,0,130019,9,276,285
597,MACBETH 1988,2799049,0,90957,8,77,85
598,MACBETH 2000,489308,45,10926,8,13,21
599,MACBETH 2008,4105572,80,51048,11,52,63
600,MACHINAL,2123256,51,40813,28,52,80
601,MAGIC/BIRD,1136102,33,34446,24,37,61
602,MAIL,383246,0,21340,19,37,56
603,MAJOR BARBARA,3217456,49,65138,32,74,106
604,MAMMA MIA!,624391693,82,7566124,14,5758,5772
605,MAN AND BOY,3095607,57,53701,35,57,92
606,MAN OF LA MANCHA,22483426,66,343317,16,304,320
607,MAN OF LA MANCHA 1992,8018715,0,167938,28,108,136
608,MANDY PATINKIN,563627,46,12229,0,16,16
609,MANDY PATINKIN IN CONCERT: MAMALOSHEN,726465,42,17344,0,28,28
610,MANDY PATINKIN: DRESS CASUAL,747986,0,24735,0,62,62
611,MANILOW ON BROADWAY,4160716,121,35432,2,25,27
612,MARC SALEM'S MIND GAMES,287897,43,6866,1,30,31
613,MARIE CHRISTINE,2982095,43,69819,39,42,81
614,MARK TWAIN TONIGHT,617468,52,12184,3,15,18
615,MARLENE,681313,32,21342,15,25,40
616,MARRIAGE OF FIGARO,664010,0,40852,22,77,99
617,MARTIN SHORT: FAME BECOMES ME,10842526,75,143480,22,165,187
618,MARVIN'S ROOM,2366005,50,47375,23,68,91
619,MARY POPPINS,294558648,75,3877521,30,2619,2649
620,MARY STUART,6088106,59,103007,22,137,159
621,MASTER CLASS,3244777,61,52956,26,67,93
622,Master Class 1995,15082029,33,424668,12,598,610
623,MASTER HAROLDâ€¦AND THE BOYS,2276295,41,55872,31,49,80
624,MASTERGATE,691392,0,26715,23,69,92
625,MATCH,2333156,47,49757,28,53,81
626,MATILDA,198165852,94,2087293,37,1554,1591
627,MATTERS OF THE HEART,628230,36,17160,8,11,19
628,MAURITIUS,2293948,56,41237,24,61,85
629,ME AND MY GIRL,79655591,0,2061437,11,1417,1428
630,MEAN GIRLS,124199593,126,980469,29,801,830
631,MEDEA,2454181,41,58891,6,78,84
632,MEDEA 1994,3435444,0,84470,9,83,92
633,MEET ME IN ST. LOUIS,9737393,0,289739,17,252,269
634,MEL BROOKS,583140,197,2967,0,2,2
635,MEMPHIS,104453830,75,1380731,30,1165,1195
636,MEN ARE FROM MARS WOMEN ARE FROM VENUS,358316,32,11336,0,7,7
637,METAMORPHOSES,10455094,52,199094,13,400,413
638,METAMORPHOSIS,2684265,0,81045,5,96,101
639,METEOR SHOWER,10904520,154,70925,31,61,92
640,METRO,362026,0,20470,24,13,37
641,MICHAEL FEINSTEIN IN CONCERT,1031433,0,31308,0,57,57
642,MICHAEL FEINSTEIN: ISN'T IT ROMANTIC,779339,0,23485,0,39,39
643,MICHAEL FEINSTEIN: PIANO AND VOICE,599078,0,19023,0,30,30
644,MIKE TYSON: UNDISPUTED TRUTH,1204618,133,9160,2,10,12
645,MILLION DOLLAR QUARTET,28585196,75,379726,34,489,523
646,MINNELLI ON MINNELLI,2549836,89,29519,5,20,25
647,MISERY,12518415,112,112692,27,102,129
648,MISS MARGARIDA'S WAY,88048,0,11120,8,11,19
649,MISS SAIGON,322103948,28,6584913,43,4432,4475
650,MIXED EMOTIONS,529998,0,30482,16,56,72
651,MOON FOR MISBEGOTTEN,62406,0,3928,0,7,7
652,MOON OVER BUFFALO,11370536,25,317122,22,309,331
653,MORNING NOON AND NIGHT,504719,33,15504,7,12,19
654,MORNING'S AT SEVEN,2766340,36,75829,27,112,139
655,MORRISSEY,1881374,187,10085,0,7,7
656,MORT SAHL ON BROADWAY,192815,0,22329,5,26,31
657,MOSCOW CIRCUS,516462,0,17796,0,32,32
658,MOTHERS AND SONS,3558406,60,60704,33,104,137
659,MOTOWN THE MUSICAL,116498633,107,1083376,37,762,799
660,MOULIN ROUGE!,72260393,195,371285,24,260,284
661,MOVIN' OUT,99473905,69,1429115,28,1295,1323
662,MRS. WARREN'S PROFESSION,2917482,52,56201,35,65,100
663,MULE BONE,907603,0,65135,28,68,96
664,MUMMENSCHANZ,190000,0,22800,0,152,152
665,MY FAIR LADY,79772272,97,731887,55,674,729
666,MY FAVORITE YEAR,2005376,0,73023,45,36,81
667,MY LOVE LETTER TO BROADWAY,1854959,114,16313,0,12,12
668,MY NAME IS LUCY BARTON,4289821,117,36179,10,47,57
669,MY ONE AND ONLY,12143496,0,388016,0,312,312
670,MY THING OF LOVE,276763,0,18612,16,12,28
671,"NATASHA, PIERRE & THE GREAT COMET OF 1812",50069392,124,404558,32,336,368
672,NERD,3624602,0,191117,15,441,456
673,NETWORK,31370836,145,215717,28,184,212
674,NEVER GONNA DANCE,6287836,62,101949,44,84,128
675,NEWS,115500,0,2875,22,4,26
676,NEWSIES,109000717,94,1156757,16,1004,1020
677,NEXT FALL,3056830,54,57552,26,132,158
678,NEXT TO NORMAL,31764486,66,473884,20,734,754
679,NICE WORK IF YOU CAN GET IT,51461746,94,543472,27,478,505
680,NICHOLAS NICKLEBY,2136298,0,23933,3,29,32
681,NICK AND NORA,3994646,0,108368,71,9,80
682,NIGHT MUST FALL,2927757,37,81461,40,119,159
683,NO MAN'S LAND,1278139,0,39175,22,61,83
684,NO MAN'S LAND/WAITING FOR GODOT,14346510,89,160950,31,145,176
685,NOISES OFF,20017476,55,366417,51,415,466
686,NOISES OFF 1984-1985,6030479,0,252056,0,352,352
687,NOT ABOUT NIGHTINGALES,2465086,42,59027,13,125,138
688,NOVEMBER,11194646,70,160076,38,200,238
689,OBA OBA,632135,0,31313,18,46,64
690,OBA OBA '90,1246379,0,57143,10,45,55
691,OBA OBA '93,426432,0,26313,24,22,46
692,OCTETTE BRIDGE CLUB,159337,0,12156,8,24,32
693,OF MICE AND MEN,15938704,103,155377,31,118,149
694,OH CALCUTTA!,11704235,0,826527,8,2580,2588
695,OH COWARD,185000,0,16200,16,56,72
696,OH KAY!,2491192,0,89242,35,77,112
697,"OH, HELLO ON BROADWAY",10160117,90,112188,18,120,138
698,OKLAHOMA!,22808138,107,212244,22,328,350
699,OKLAHOMA! 2002/2003,34961595,63,549805,25,388,413
700,OLD ACQUAINTANCE,1809462,42,42829,31,61,92
701,OLD TIMES,4039575,77,52787,21,64,85
702,OLDEST LIVING CONFEDERATE WIDOW TELLS ALL,225202,38,6752,19,1,20
703,OLEANNA,2177335,55,39824,15,65,80
704,ON A CLEAR DAY YOU CAN SEE FOREVER,7253179,83,88565,29,57,86
705,ON BORROWED TIME,1303639,0,54810,21,101,122
706,ON GOLDEN POND,2947551,54,54757,19,93,112
707,ON THE TOWN,30840328,66,461901,28,368,396
708,ON THE TOWN 1988,5236292,37,143790,32,69,101
709,ON THE TWENTIETH CENTURY,11298280,91,123479,33,144,177
710,ON THE WATERFRONT,375890,0,20691,16,8,24
711,ON YOUR FEET!,83571600,94,879193,34,746,780
712,ONCE,110306780,100,1082027,23,1168,1191
713,ONCE ON THIS ISLAND,30783523,98,311099,29,457,486
714,ONCE ON THIS ISLAND Original Production,7109144,0,288391,19,469,488
715,ONCE UPON A MATTRESS,7991729,45,174914,35,188,223
716,ONE FLEW OVER THE CUCKOO'S NEST,6477718,53,122341,24,121,145
717,"ONE MAN, TWO GUVNORS",13071416,93,140382,13,159,172
718,ONE MO' TIME,514302,39,13080,16,21,37
719,ORPHANS,4056117,72,55985,27,37,64
720,ORPHEUS DESCENDING,3598732,0,115625,13,97,110
721,OSLO,10875255,88,123509,23,109,132
722,OTHER DESERT CITIES,14799861,85,171304,25,261,286
723,OUR COUNTRY'S GOOD,513073,0,44965,12,48,60
724,OUR MOTHER'S BRIEF AFFAIR,1727741,49,35508,22,53,75
725,OUR TOWN,3757006,67,55571,15,59,74
726,OUR TOWN 1988-1989,1625788,0,91557,27,136,163
727,OUTSIDE MULLINGAR,3351777,66,50227,22,61,83
728,PACIFIC OVERTURES,3770036,53,71420,24,69,93
729,PACK OF LIES,1128508,0,59197,5,120,125
730,PAL JOEY,5574587,54,103821,37,85,122
731,PARADE,4349262,41,104752,39,85,124
732,PARAMOUR,50071361,86,579261,31,366,397
733,PARK YOUR CAR IN HARVARD YARD,1993298,0,89633,9,124,133
734,PASS OVER,1829204,42,45306,19,57,76
735,PASSING STRANGE,5161374,53,97370,20,165,185
736,PASSION,10680035,0,238899,52,280,332
737,PATTI LABELLE ON BROADWAY,989597,56,17835,0,12,12
738,PATTI LUPONE ON BROADWAY,1640359,0,39633,8,45,53
739,PAUL ROBESON,420109,13,14327,7,25,32
740,PENN & TELLER ON BROADWAY,7418335,117,64567,7,41,48
741,PENN AND TELLER,2531878,0,94586,8,122,130
742,PETER AND THE STARCATCHER,17698854,68,255200,18,319,337
743,PETER PAN,10218898,41,247843,0,174,174
744,PETER PAN 1990-1991,7901151,19,171397,8,133,141
745,PHILADELPHIA: HERE I COME,1181442,0,37123,25,52,77
746,PICNIC,3349762,28,81257,62,94,156
747,PIPPIN,68840074,103,659865,37,709,746
748,PLAY ON!,1402692,23,61278,19,61,80
749,PORGY AND BESS,26381453,90,293984,28,293,321
750,PRECIOUS SONS,573384,0,34808,28,60,88
751,PRELUDE TO A KISS,1786550,43,41211,23,61,84
752,PRELUDE TO A KISS 1990-1991,5819573,0,194011,8,440,448
753,PRESENT LAUGHTER,15484083,74,196609,51,170,221
754,PRESENT LAUGHTER 1996-1997,4334972,33,133335,28,175,203
755,PRETTY WOMAN: THE MUSICAL,51134569,113,449208,27,420,447
756,PRIMO,1952699,65,29520,4,35,39
757,PRINCE OF BROADWAY,4171311,77,54277,23,76,99
758,PRISCILLA QUEEN OF THE DESERT,48763901,79,616609,23,526,549
759,PRIVATE LIVES,445166,72,6204,0,9,9
760,PRIVATE LIVES 1992,934802,0,30266,11,37,48
761,PRIVATE LIVES 2002,7083941,54,132104,9,127,136
762,PRIVATE LIVES 2011,2328466,64,36814,12,44,56
763,PROMISES PROMISES,42951936,91,475458,30,289,319
764,PROOF,32896994,51,634994,16,917,933
765,PROPOSALS,2172196,43,51007,10,77,87
766,PRUNE DANISH,2080448,59,35323,14,39,53
767,PRYMATE,111855,33,3303,22,5,27
768,PUTTING IT TOGETHER,5371370,57,94783,22,101,123
769,PYGMALION,3558323,53,66932,31,69,100
770,PYGMALION 1987,2492885,0,82271,15,113,128
771,QED,2165492,46,47492,8,40,48
772,QUILTERS,105736,0,6669,5,24,29
773,RABBIT HOLE,3203305,55,58154,23,77,100
774,RACE,14939910,74,197595,23,297,320
775,RACING DEMON,1160216,16,43851,8,56,64
776,RADIO GOLF,1825735,39,46200,17,64,81
777,RAGGEDY ANN,156625,0,10962,15,5,20
778,RAGS,587081,0,24641,18,4,22
779,RAGTIME,6030275,65,92587,28,65,93
780,RAGTIME 1997-2000,79947694,56,1432872,27,834,861
781,RAIN: A TRIBUTE TO THE BEATLES ON BROADWAY,18014434,66,260709,8,300,308
782,REASONS TO BE PRETTY,1936204,44,43457,21,85,106
783,RECKLESS,3004690,50,59677,24,77,101
784,RED,6835696,76,87631,22,101,123
785,REDWOOD CURTAIN,571015,0,34484,11,40,51
786,REGINA SPEKTOR,743114,102,7319,0,5,5
787,RELATIVELY SPEAKING,10077527,79,126852,35,117,152
788,RENT,274248128,54,5026616,16,5123,5139
789,REQUIEM FOR A HEAVYWEIGHT,114973,0,7355,8,3,11
790,RING OF FIRE,2775120,56,50623,38,57,95
791,RING ROUND THE MOON,1282880,27,47453,31,66,97
792,RINK,1695147,0,61030,0,72,72
793,RIVERDANCE,45553810,51,890766,13,605,618
794,ROCK 'N' ROLL,6767495,66,102787,16,123,139
795,ROCK OF AGES,128993202,89,1476471,22,2328,2350
796,ROCKTOPIA,4419436,65,67437,8,40,48
797,ROCKY,19222100,82,235400,28,180,208
798,ROMANCE ROMANCE,3221064,0,123774,13,297,310
799,ROMEO AND JULIET,6208798,75,84914,27,93,120
800,ROSE,1230595,30,40598,13,42,55
801,ROWAN ATKINSON AT THE ATKINSON,53303,0,2899,7,7,14
802,ROYAL SHAKESPEARE COMPANY - CYRANO AND MUCH ADO,4668586,0,181064,9,112,121
803,ROZA,559330,0,20266,20,12,32
804,RUBEN & CLAY'S FIRST ANNUAL CHRISTMAS CAROL FAMILY FUN PAGEANT SPECTACULAR,566548,36,15813,6,24,30
805,RUMORS,12880034,0,447611,8,535,543
806,RUN FOR YOUR WIFE,460213,0,31540,13,47,60
807,RUNNING ON EMPTY,997676,90,11120,0,8,8
808,SACRILEGE,357454,0,15394,8,21,29
809,SAFE SEX,255062,0,12920,21,9,30
810,SAINT JOAN,2897635,29,75082,39,103,142
811,SALLY MARR AND HER ESCORTS,679156,0,21088,27,50,77
812,SALOME,3702428,66,56181,18,40,58
813,SARAFINA,13504133,0,548087,11,597,608
814,SATURDAY NIGHT FEVER,37585638,55,680429,27,501,528
815,SAY GOODNIGHT GRACIE,5874615,45,131349,27,364,391
816,SCANDALOUS,1718924,44,42216,31,29,60
817,SCHOOL FOR SCANDAL,267650,16,9949,7,33,40
818,SCHOOL OF ROCK,160145109,95,1668057,31,1309,1340
819,SEA WALL/A LIFE,6509397,97,69022,14,60,74
820,SEARCH AND DESTROY,419612,0,28882,22,46,68
821,SEARCH FOR SIGNS,11404463,0,421543,14,391,405
822,SEASCAPE,1526743,41,38021,27,55,82
823,SEMINAR,9819692,72,132687,25,191,216
824,SENATOR JOE,5661,0,470,3,0,3
825,SERIOUS MONEY,413435,0,18856,21,15,36
826,SEUSSICAL,12927734,56,228686,34,198,232
827,SEVEN GUITARS,4341182,34,130145,13,188,201
828,SEX AND LONGING,1474936,23,65593,30,46,76
829,Sexaholix 2001-2002,5337342,49,109522,53,67,120
830,Sexaholix 2003,990923,49,20224,0,28,28
831,SHADOW BOX,636598,0,27956,19,49,68
832,SHADOWLANDS,2712597,0,124173,11,169,180
833,SHAKESPEARE FOR MY FATHER,2667045,0,97148,8,266,274
834,SHATNER'S WORLD: WE JUST LIVE IN IT,914006,67,13721,2,17,19
835,SHE LOVES ME,22460756,24,422778,73,486,559
836,SHENANDOAH,798610,0,32251,15,32,47
837,SHERLOCK'S LAST CASE,2122057,0,83806,12,124,136
838,SHIMADA,218103,0,11950,20,4,24
839,SHINING CITY,3217082,55,57529,21,80,101
840,SHIRLEY VALENTINE,3918566,0,170791,8,324,332
841,SHOGUN: THE MUSICAL,2913428,0,88687,18,72,90
842,SHOW BOAT,89171712,25,1585144,12,947,959
843,SHREK THE MUSICAL,46361426,76,606280,37,441,478
844,"SHUFFLE ALONG, OR, THE MAKING OF THE MUSICAL SENSATION OF 1921 AND ALL THAT",15174445,116,131619,38,100,138
845,SID CEASAR AND COMPANY,48958,0,2455,6,5,11
846,SIDE MAN,9808327,35,276876,27,517,544
847,SIDE SHOW,9278312,50,188033,52,147,199
848,SIGHT UNSEEN,2724614,54,50622,21,70,91
849,SIGNIFICANT OTHER,1707469,50,35075,18,61,79
850,SINGIN' IN THE RAIN,13303713,0,441579,38,367,405
851,SISTER ACT,52509237,73,721574,28,561,589
852,SIX DANCE LESSONS IN SIX WEEKS,716751,32,22321,26,30,56
853,SIX DEGREES OF SEPARATION,18983263,10,503721,32,548,580
854,SIXTEEN WOUNDED,509381,38,13482,28,12,40
855,SKELETON CREW,1122880,38,28022,22,30,52
856,SKYLIGHT,14640395,78,191759,33,201,234
857,SLAVA'S SNOWSHOW,5404274,82,66447,10,97,107
858,SLAVE PLAY,10124246,68,142476,38,178,216
859,SLEIGHT OF HAND,309141,0,21844,31,9,40
860,SLY FOX,8121077,57,141591,22,173,195
861,SMILE,1605546,0,53631,11,48,59
862,SMOKEY JOE'S CAFE,88346877,40,1904856,25,2036,2061
863,SO LONG LONELY STREET,119659,0,11313,8,53,61
864,SOCIAL SECURITY,7412113,0,282222,26,388,414
865,SOLITARY CONFINEMENT,394967,0,29074,15,25,40
866,SOME AMERICANS ABROAD,480112,0,27761,6,55,61
867,SOMEONE WHO'LL WATCH OVER ME,3943981,0,133087,5,232,237
868,SOMETHING ROTTEN!,73500381,84,870214,32,708,740
869,SONDHEIM ON SONDHEIM,5352642,60,89781,37,76,113
870,SONG AND DANCE,13004714,0,395212,17,474,491
871,SOUL DOCTOR,1940459,39,51690,32,66,98
872,SOUL OF SHAOLIN,1225360,41,30406,3,21,24
873,SOUTH PACIFIC,96518652,99,965647,37,996,1033
874,SOUVENIR,945935,43,21953,14,68,82
875,SPAMALOT,168067350,80,2075781,34,1575,1609
876,SPEED THE PLOW,8477093,73,114722,24,140,164
877,SPEED-THE-PLOW,5543129,0,236777,23,279,302
878,SPIDER-MAN TURN OFF THE DARK,212406040,101,2067661,182,1066,1248
879,SPOILS OF WAR,640059,0,30209,14,36,50
880,SPONGEBOB SQUAREPANTS,37315330,76,485793,29,327,356
881,SPRING AWAKENING,66623990,74,886425,51,994,1045
882,SPRINGSTEEN ON BROADWAY,113058952,506,223585,7,229,236
883,SQUONK,466157,35,13579,24,32,56
884,STAND-UP TRAGEDY,74326,0,4258,12,13,25
885,STANLEY,1197565,24,48320,18,77,95
886,STARDUST,776361,0,52993,16,101,117
887,STARLIGHT EXPRESS,42622032,0,1153702,22,761,783
888,STARMITES,520358,0,23948,35,60,95
889,STATE FAIR,2926843,40,73138,8,110,118
890,STEEL MAGNOLIAS,4139622,57,72860,23,136,159
891,STEEL PIER,5587523,47,120530,33,76,109
892,STEPPING OUT,1006542,0,46054,21,73,94
893,STICK FLY,4262543,53,80312,24,93,117
894,STONES IN HIS POCKETS,5141100,44,115757,11,198,209
895,STRAIGHT WHITE MEN,3629411,81,44978,27,56,83
896,STRANGE INTERLUDE,1602954,0,44844,7,63,70
897,STREET CORNER SYMPHONY,1090010,17,64792,25,79,104
898,SUMMER,31490520,97,321684,27,288,315
899,SUMMER AND SMOKE,1194418,33,36681,22,53,75
900,SUNDAY IN THE PARK WITH GEORGE,19000206,84,225866,43,210,253
901,SUNDAY IN THE PARK WITH GEORGE 1984-1985,13820056,0,405866,0,568,568
902,SUNSET BOULEVARD,107159659,42,1689005,24,1115,1139
903,SUPERIOR DONUTS,4239113,58,74490,17,109,126
904,SWAN LAKE,7027858,50,141151,11,124,135
905,SWEAT,4881458,70,70653,24,105,129
906,SWEENEY TODD,20856882,74,282403,11,349,360
907,SWEENEY TODD 1989-1990,2447741,0,103111,47,188,235
908,SWEET CHARITY,34027372,27,744524,40,648,688
909,SWEET CHARITY 86-87,15373615,0,444510,15,369,384
910,SWEET SMELL OF SUCCESS,7860322,66,119972,18,109,127
911,SWEET SUE,2466416,0,103903,16,164,180
912,SWING!,24623691,47,529583,43,461,504
913,SWINGING ON A STAR,1772083,16,51442,19,96,115
914,SYLVIA,4453376,60,75926,27,79,106
915,TABOO,4894998,71,70160,16,100,116
916,TAKE ME ALONG,71190,0,4320,7,1,8
917,TAKING SIDES,1723675,26,67592,15,85,100
918,TAKING STEPS,852636,0,51389,22,78,100
919,TALK RADIO,4489013,53,84405,29,121,150
920,TALLER THAN A DWARF,2557061,39,65891,37,56,93
921,TANGO ARGENTINO,8561544,11,249818,8,262,270
922,TANGO PASION,138027,0,5873,6,5,11
923,TARTUFFE,2638852,43,61354,40,53,93
924,TARTUFFE 1997,321371,19,17029,25,29,54
925,TARZAN,42722858,73,580903,35,486,521
926,TEDDY AND ALICE,2156947,0,65251,11,77,88
927,THAT CHAMPIONSHIP SEASON,8443019,85,99407,28,97,125
928,THE 25TH ANNUAL PUTNAM COUNTY SPELLING BEE,45625516,67,672139,21,1136,1157
929,THE 39 STEPS,22104342,57,389835,31,763,794
930,THE ADDAMS FAMILY,86677092,92,920997,35,722,757
931,THE ADVENTURES OF TOM SAWYER,2211829,34,64852,34,21,55
932,THE AMERICAN PLAN,2001797,51,38583,22,70,92
933,THE ANARCHIST,1651411,73,22583,23,17,40
934,THE APPLE DOESN'T FALL,98544,19,5256,19,1,20
935,THE APPLE TREE,4777523,54,87752,18,99,117
936,THE ASSEMBLED PARTIES,5402056,65,82288,28,119,147
937,THE AUDIENCE,22072987,151,146613,22,114,136
938,THE BAND'S VISIT,67910865,110,612394,36,588,624
939,THE BEAUTY QUEEN OF LEENANE,12496388,44,281378,19,365,384
940,THE BEST LITTLE WHOREHOUSE GOES PUBLIC,756503,0,40023,28,16,44
941,THE BIG KNIFE,2337664,51,45618,29,56,85
942,THE BIG LOVE,519527,0,25658,11,41,52
943,THE BLONDE IN THE THUNDERBIRD,191165,14,15122,10,9,19
944,THE BLUE ROOM,4589721,45,101355,15,81,96
945,THE BOY FROM OZ,42738338,81,524857,32,364,396
946,THE BOYS FROM SYRACUSE,3286075,48,68115,29,73,102
947,THE BOYS IN THE BAND,14943570,160,93222,35,84,119
948,THE BRIDGES OF MADISON COUNTY,6729931,67,101215,37,100,137
949,THE CAINE MUTINY COURT-MARTIAL,945803,49,19409,27,17,44
950,THE CAPEMAN,8038402,53,152983,59,68,127
951,THE CARETAKER,2156333,45,48149,19,63,82
952,THE CEMETERY CLUB,363036,0,36367,10,56,66
953,THE CHAIRS,1830517,38,48303,10,74,84
954,THE CHER SHOW,39260781,105,375095,34,295,329
955,THE CHERRY ORCHARD,4699478,69,68736,36,69,105
956,THE CHILDREN,2390093,57,41588,15,63,78
957,THE CIRCLE,4075985,0,150710,8,208,216
958,THE CIVIL WAR,3524775,43,81971,35,61,96
959,THE COAST OF UTOPIA,10085758,72,139695,25,120,145
960,THE COAST OF UTOPIA [PART 1 - VOYAGE],1676577,59,30838,31,1,32
961,THE COLOR PURPLE,148718479,83,1818873,63,1360,1423
962,THE COLUMNIST,3505086,59,59702,23,86,109
963,THE COMEDY OF ERRORS,980176,0,59348,23,65,88
964,THE CONSTANT WIFE,3365506,53,63263,23,77,100
965,THE COUNTRY GIRL,5949235,74,81577,25,97,122
966,THE COUNTRY HOUSE,2383928,54,44110,26,61,87
967,THE CRIPPLE OF INISHMAAN,7845617,83,94219,9,105,114
968,THE CRUCIBLE,19344830,79,246671,51,226,277
969,THE CRUCILE 1991-1992,1185344,0,50154,23,31,54
970,THE CURIOUS INCIDENT OF THE DOG IN THE NIGHT-TIME,68321435,94,712343,23,799,822
971,THE DEEP BLUE SEA,1379259,36,38764,29,61,90
972,THE DEVIL'S DISCIPLE,897856,0,55502,27,113,140
973,THE DIARY OF ANNE FRANK,6086337,38,156663,15,221,236
974,THE DINNER PARTY,13974313,48,291757,20,364,384
975,THE DROWSY CHAPERONE,63565088,72,865975,32,674,706
976,THE ELEPHANT MAN,16291917,112,136696,58,140,198
977,THE ENCOUNTER,4370573,65,67056,11,117,128
978,THE FARNSWORTH INVENTION,4512535,59,76700,34,104,138
979,THE FATHER,4739487,51,90104,55,130,185
980,THE FERRYMAN,29427550,108,270524,20,296,316
981,THE FLOWERING PEACH,354805,0,16725,14,41,55
982,THE FLYING KARAMAZOV BROTHERS,658808,0,19501,7,50,57
983,THE FROGS,7691480,66,117040,34,92,126
984,THE FRONT PAGE,23135177,81,237246,60,174,234
985,THE GATHERING,360983,32,11208,12,24,36
986,THE GERSHWINS' FASCINATING RHYTHM,970692,37,26455,27,17,44
987,THE GIN GAME,7775151,50,152435,42,237,279
988,THE GLASS MENAGERIE,25419579,67,337554,103,435,538
989,THE GLASS MENAGERIE REVIVAL 94-95,1302177,0,37380,19,57,76
990,THE GOAT OR WHO IS SYLVIA?,7932478,44,179887,23,309,332
991,THE GOOD BODY,843035,43,19837,27,40,67
992,THE GOODBYE GIRL,11456076,0,264638,23,188,211
993,THE GOSPEL AT COLONUS,1166390,0,50165,15,61,76
994,THE GOVERNMENT INSPECTOR,476817,0,20677,16,37,53
995,THE GRADUATE,17834908,54,321840,24,380,404
996,THE GRAPES OF WRATH,5031529,0,158138,11,188,199
997,THE GREAT SOCIETY,4755412,73,65268,26,72,98
998,THE GREEN BIRD,1787997,50,37182,15,56,71
999,THE HEIDI CHRONICLES,16413783,7,543543,35,675,710
1000,THE HEIGHT OF THE STORM,3161762,75,42281,15,72,87
1001,THE HEIRESS,19273881,29,423708,60,457,517
1002,THE HIGH ROLLERS SOCIAL AND PLEASURE CLUB,110732,0,7243,19,13,32
1003,THE HISTORY BOYS,16986043,77,219895,13,185,198
1004,THE HOMECOMING,4267706,56,75092,15,137,152
1005,THE HOMECOMING 1991,635768,0,29202,23,49,72
1006,THE HOUSE OF BLUE LEAVES,5707721,76,74693,21,72,93
1007,THE HUMANS,24441207,92,266108,28,365,393
1008,THE ICEMAN COMETH,21685048,105,211696,38,169,207
1009,THE ILLUSIONISTS - LIVE ON BROADWAY,6785761,102,64713,0,64,64
1010,THE ILLUSIONISTS - MAGIC OF THE HOLIDAYS,14973669,104,137931,0,116,116
1011,THE ILLUSIONISTS - TURN OF THE CENTURY,5847010,81,68843,0,57,57
1012,THE ILLUSIONISTS - WITNESS THE IMPOSSIBLE,8157068,105,76365,9,45,54
1013,THE IMPORTANCE OF BEING EARNEST,8012925,65,122818,30,189,219
1014,THE INHERITANCE,10904126,92,117559,45,130,175
1015,THE INVENTION OF LOVE,3918862,37,104598,31,108,139
1016,THE JUDAS KISS,4629082,46,99964,6,103,109
1017,THE KENTUCKY CYCLE,863562,0,28251,15,33,48
1018,THE KING AND I,104348686,77,1397860,66,1279,1345
1019,The King and I1984-1985,12556649,0,328128,16,191,207
1020,THE LAST NIGHT OF BALLYHOO,11548547,47,243216,24,556,580
1021,THE LAST SHIP,11156287,84,131411,29,105,134
1022,THE LEHMAN TRILOGY,13467763,136,100012,18,82,100
1023,THE LIEUTENANT OF INISHMORE,3808107,50,76621,16,142,158
1024,THE LIFE,18961995,49,384256,21,466,487
1025,THE LIFESPAN OF A FACT,14409286,125,115552,32,101,133
1026,THE LIGHT IN THE PIAZZA,28777131,68,420433,36,504,540
1027,THE LIGHTNING THIEF,5061724,61,79999,30,95,125
1028,THE LION IN WINTER,2099821,41,51829,22,93,115
1029,THE LITTLE DOG LAUGHED,3345956,49,68122,22,112,134
1030,THE LITTLE FOXES,7973018,63,134141,49,144,193
1031,THE LITTLE MERMAID,82993600,83,986179,50,685,735
1032,THE LITTLE PRINCE,1888591,61,34889,14,32,46
1033,THE LONESOME WEST,619334,31,20296,9,55,64
1034,THE LOOK OF LOVE,2344600,40,59883,35,49,84
1035,THE LYONS,2509091,45,57421,21,80,101
1036,THE MAN WHO CAME TO DINNER,3854225,49,79268,32,85,117
1037,THE MAN WHO HAD ALL THE LUCK,2610518,45,57457,15,70,85
1038,THE MASTER BUILDER,786602,0,35635,11,44,55
1039,THE MERCHANT OF VENICE,15335104,133,115374,20,79,99
1040,THE MERCHANT OF VENICE 1989-1990,5444942,0,131041,19,84,103
1041,THE MIKADO,490302,0,23368,3,37,40
1042,THE MIRACLE WORKER,1687067,47,36610,21,38,59
1043,THE MISER,970436,0,62373,23,93,116
1044,THE MOLIERE COMEDIES,1487984,0,41638,26,61,87
1045,THE MOST HAPPY FELLA,4754838,0,156146,23,229,252
1046,THE MOTHERF**KER WITH THE HAT,10451323,81,130240,28,112,140
1047,THE MOUNTAINTOP,10864181,88,123293,24,117,141
1048,THE MUSICAL COMEDY MURDERS,1091537,0,66736,6,136,142
1049,THE MYSTERY OF CHARLES DICKENS,253992,33,7526,7,20,27
1050,THE MYSTERY OF EDWIN DROOD,7191342,58,122792,28,136,164
1051,THE NANCE,8563126,77,112339,28,136,164
1052,THE NAP,1819944,48,38426,25,53,78
1053,THE NEW ONE,4007178,61,65512,18,81,99
1054,THE NIGHT OF THE IGUANA,1540907,36,43376,18,69,87
1055,The Night of the Iguana 1988,568644,0,38378,11,81,92
1056,THE NORMAL HEART,4237705,61,67970,10,86,96
1057,THE NORMAN CONQUESTS,4256181,56,75224,18,109,127
1058,THE ODD COUPLE,28938436,97,296923,28,249,277
1059,THE ODD COUPLE 1985-1986,5556919,0,215658,9,295,304
1060,THE OLD NEIGHBORHOOD,3820480,34,111014,11,197,208
1061,THE OTHER PLACE,2876466,57,49929,34,61,95
1062,THE PAJAMA GAME,8885204,75,120528,41,129,170
1063,THE PARISIAN WOMAN,9771836,88,110665,25,116,141
1064,THE PEE-WEE HERMAN SHOW,6296959,98,64173,18,62,80
1065,THE PEOPLE IN THE PICTURE,2469422,44,56633,30,60,90
1066,THE PERFORMERS,737219,37,19860,24,6,30
1067,THE PETITION,883085,0,48859,10,75,85
1068,THE PHILANTHROPIST,2463705,49,49691,19,73,92
1069,THE PIANO LESSON,6396570,0,259106,8,328,336
1070,THE PILLOWMAN,8946186,65,137521,23,185,208
1071,THE PIRATE QUEEN,9054539,61,149476,32,85,117
1072,THE PITMEN PAINTERS,2330017,52,44965,18,78,96
1073,THE PLAY THAT GOES WRONG,34341708,68,500844,27,737,764
1074,THE PLAY WHAT I WROTE,2530951,40,63237,27,89,116
1075,THE PLAY'S THE THING,969991,0,32156,26,45,71
1076,THE PRESENT,10880989,124,88013,22,81,103
1077,THE PRICE,7546779,102,73903,31,69,100
1078,The Price 1992,715800,0,29398,25,46,71
1079,The Price 1999-2000,3013098,34,90661,20,128,148
1080,THE PRINCE OF CENTRAL PARK,128907,0,7738,19,4,23
1081,THE PRODUCERS,288361724,78,3672795,33,2502,2535
1082,THE PROM,25012263,84,295187,23,309,332
1083,THE RAINMAKER,3321242,38,88453,25,82,107
1084,THE RASCALS: ONCE UPON A DREAM,2245793,122,18432,1,14,15
1085,THE REAL INSPECTOR HOUND,855076,0,32296,17,61,78
1086,THE REAL THING,19754682,26,481689,56,604,660
1087,THE REALISTIC JONESES,8209761,86,95429,27,105,132
1088,THE RED SHOES,2568652,0,66477,51,5,56
1089,THE REGARD OF FLIGHT,232287,0,13127,7,17,24
1090,THE REHEARSAL,1147712,32,36206,25,55,80
1091,THE RETREAT FROM MOSCOW,4496405,50,89666,24,147,171
1092,THE RIDE DOWN MT. MORGAN,3948515,40,99678,23,121,144
1093,THE RISE AND FALL OF LITTLE VOICE,193203,0,17936,19,9,28
1094,THE RITZ,3438536,46,75147,30,69,99
1095,THE RIVALS,2275152,49,46130,23,45,68
1096,THE RIVER,10827016,135,80722,18,97,115
1097,THE ROAD TO MECCA,2082656,48,42360,34,56,90
1098,THE ROCKY HORROR SHOW,13431400,50,268017,30,437,467
1099,THE ROSE TATTOO,6442169,46,101305,37,136,173
1100,THE ROYAL FAMILY,2627586,49,53252,26,77,103
1101,THE SCARLET PIMPERNEL,40692704,44,924543,39,772,811
1102,THE SCOTTSBORO BOYS,2750411,52,52266,29,49,78
1103,THE SEAFARER,4512348,57,76919,19,133,152
1104,THE SEAGULL,6430741,75,85825,18,94,112
1105,THE SEAGULL 1992-1993,790509,0,33938,15,49,64
1106,THE SEARCH FOR SIGNS OF INTELLIGENT LIFE IN THE UNIVERSE,5562894,48,114278,6,184,190
1107,THE SECRET GARDEN,31609844,0,815536,23,709,732
1108,THE SECRET RAPTURE,256723,0,14288,19,12,31
1109,THE SHOW-OFF,636120,0,25160,26,45,71
1110,THE SISTERS ROSENSWEIG,19086077,0,510634,18,556,574
1111,THE SMELL OF THE KILL,533380,30,17858,20,40,60
1112,THE SNOW GEESE,2376183,54,44083,25,60,85
1113,THE SONG OF JACOB ZULU,1281899,0,45768,9,53,62
1114,THE SOUND INSIDE,8329312,86,96171,37,100,137
1115,THE SOUND OF MUSIC,34483971,54,642006,38,533,571
1116,THE SPEED OF DARKNESS,375965,0,24474,16,36,52
1117,THE STORY OF MY LIFE,264611,40,6628,19,5,24
1118,THE SUNSHINE BOYS,5023827,39,127504,12,230,242
1119,THE TALE OF THE ALLERGIST'S WIFE,29310727,48,612691,25,777,802
1120,THE TAP DANCE KID,14946615,0,595928,0,496,496
1121,THE TEMPEST,4609277,22,91218,25,70,95
1122,THE TEMPTATIONS AND THE FOUR TOPS ON BROADWAY,819461,93,8780,0,7,7
1123,THE TENTH MAN,714838,0,47284,35,41,76
1124,THE TERMS OF MY SURRENDER,4209550,59,74484,13,83,96
1125,THE TESTAMENT OF MARY,1279803,40,32424,27,16,43
1126,THE THREEPENNY OPERA,5806155,59,98279,32,77,109
1127,THE TIMES THEY ARE A-CHANGIN',2636161,53,50023,35,28,63
1128,THE TRIP TO BOUNTIFUL,13498945,86,158164,27,187,214
1129,THE VELOCITY OF AUTUMN,544617,29,19293,22,16,38
1130,THE VERTICAL HOUR,7308875,69,104375,23,117,140
1131,THE VIOLET HOUR,2037981,52,39431,23,54,77
1132,THE VISIT,3201020,26,85742,58,106,164
1133,THE WAVERLY GALLERY,7668657,77,99041,32,109,141
1134,THE WEDDING SINGER,19995744,66,301613,28,285,313
1135,THE WEIR,6874875,38,179837,10,277,287
1136,THE WILD PARTY,3919522,50,79170,36,68,104
1137,THE WINSLOW BOY,2392300,55,42745,32,53,85
1138,THE WOMAN IN WHITE,10445368,68,152490,20,109,129
1139,THE WOMEN,4183178,54,77827,32,77,109
1140,THE WORLD ACCORDING TO ME,12989003,0,547826,7,576,583
1141,THE YEAR OF MAGICAL THINKING,7293267,70,100961,23,144,167
1142,THE YOUNG MAN FROM ATLANTA,1340187,27,50356,17,84,101
1143,THÃ‰RÃˆSE RAQUIN,5184011,73,71091,30,75,105
1144,THIS IS OUR YOUTH,7229324,65,112415,26,133,159
1145,THOROUGHLY MODERN MILLIE,75616509,63,1193581,32,903,935
1146,THOSE WERE THE DAYS,1106101,0,51567,18,126,144
1147,THOU SHALT NOT,3894953,46,85740,33,85,118
1148,THOUGHTS OF A COLORED MAN,3839605,77,49442,12,77,89
1149,THREE DAYS OF RAIN,11427896,111,102670,26,70,96
1150,THREE FROM BROOKLYN,214081,0,10061,8,45,53
1151,THREE MEN ON A HORSE,1031113,0,41277,24,39,63
1152,THREE MUSKETEERS,407838,0,19845,15,9,24
1153,THREE PENNY OPERA,4721700,0,103647,20,65,85
1154,THREE SISTERS,1708904,39,43322,26,61,87
1155,THREE TALL WOMEN,13906153,133,102982,30,102,132
1156,THURGOOD,4613166,58,80291,19,126,145
1157,TIME AND THE CONWAYS,3148688,63,49620,27,56,83
1158,TIME STANDS STILL,10428041,68,154459,44,193,237
1159,TIMON OF ATHENS,510164,0,20605,16,39,55
1160,TITANIC,57150546,53,1065828,26,804,830
1161,TITLE OF SHOW,2188129,46,47894,13,102,115
1162,TO BE OR NOT TO BE,1166048,53,21960,32,40,72
1163,TO KILL A MOCKINGBIRD,137973402,144,948725,45,623,668
1164,TOMMY,54390759,0,1148704,27,899,926
1165,TOMMY TUNE TONITE,744319,0,17511,4,10,14
1166,TOOTSIE,38439038,97,396058,25,293,318
1167,TOP GIRLS,2211556,54,41199,25,62,87
1168,TOPDOG / UNDERDOG,5405007,43,121725,31,144,175
1169,TORCH SONG,3140498,66,47853,26,77,103
1170,TORCH SONG TRILOGY,1255000,0,100000,0,400,400
1171,TRANSLATIONS,2141231,49,43049,24,53,77
1172,TRANSLATIONS 1995,935190,0,27707,15,25,40
1173,TRAVESTIES,4355637,79,54305,27,63,90
1174,TRIUMPH OF LOVE,3700422,46,80669,30,85,115
1175,TROUBLE IN MIND,1713773,45,37041,20,58,78
1176,TRU,3621706,0,159968,11,297,308
1177,TRUE WEST,10922725,64,158562,51,215,266
1178,TRULY BLESSED,324829,0,16920,12,33,45
1179,TUCK EVERLASTING,2943941,51,59117,28,39,67
1180,TWELFTH NIGHT,3602900,42,84557,30,53,83
1181,TWELFTH NIGHT/RICHARD III,13930965,94,147748,28,113,141
1182,TWELVE ANGRY MEN,9325569,56,164852,32,228,260
1183,TWENTIETH CENTURY,3869161,54,72398,27,84,111
1184,TWILIGHT OF THE GOLDS,496355,0,22655,15,29,44
1185,TWILIGHT: LOS ANGELES,1106723,0,41770,7,72,79
1186,TWO SHAKESPEAREAN ACTORS,676876,0,48118,33,29,62
1187,TWO TRAINS RUNNING,3043768,0,132923,7,160,167
1188,UNCLE VANYA,2366742,37,64242,29,49,78
1189,Uncle Vanya 1995,421847,0,17968,23,29,52
1190,UPTOWN...IT'S HOT,489307,0,21329,13,24,37
1191,URBAN COWBOY,1288667,54,23533,26,60,86
1192,URINETOWN,34815864,66,524188,25,965,990
1193,VANYA AND SONIA AND MASHA AND SPIKE,13130430,94,138147,11,189,200
1194,VENUS IN FUR,9550145,76,124848,37,191,228
1195,VIA DOLOROSA,1751272,31,55886,15,99,114
1196,VICTOR/VICTORIA,58754023,53,995827,25,734,759
1197,VINCENT IN BRIXTON,1915989,38,50193,23,69,92
1198,VIOLET,6616618,70,94762,27,128,155
1199,VOICES IN THE DARK,1245034,30,42090,12,68,80
1200,WAIT UNTIL DARK,4125132,45,91598,11,97,108
1201,WAITING FOR GODOT,6908255,62,111164,32,84,116
1202,WAITING IN THE WINGS,3146238,60,52581,16,69,85
1203,WAITRESS,184781903,116,1580963,33,1666,1699
1204,WAR HORSE,74975253,102,726281,33,718,751
1205,WAR PAINT,24811139,93,264985,33,236,269
1206,WELCOME TO THE CLUB,139596,0,7113,20,12,32
1207,WELL,1162288,42,27536,23,52,75
1208,WEST SIDE STORY,19788753,116,170520,77,21,98
1209,West Side Story 2009-2011,93028454,85,1074462,27,748,775
1210,WHAT THE CONSTITUTION MEANS TO ME,11325732,107,105418,19,164,183
1211,WHAT'S WRONG WITH THIS PICTURE,608942,0,32528,27,12,39
1212,WHO'S AFRAID OF VIRGINIA WOOLF?,12116848,69,179970,31,276,307
1213,WHOOPI,2584289,51,50144,12,72,84
1214,WHOOPI GOLDBERG,1973901,0,87564,18,156,174
1215,WILD HONEY,603624,0,25153,8,28,36
1216,WILDER WILDER WILDER,301716,0,17161,14,30,44
1217,WILL ROGERS' FOLLIES,54685976,0,1155341,33,981,1014
1218,WIND IN THE WILLOWS,196902,0,10740,25,4,29
1219,WISHFUL DRINKING,5649906,56,102216,15,118,133
1220,WIT,2302405,52,44863,24,60,84
1221,WOLF HALL PARTS ONE & TWO,9970896,96,104415,21,103,124
1222,WOMEN ON THE VERGE OF A NERVOUS BREAKDOWN,4820272,66,73822,30,69,99
1223,WONDERFUL TENNESSEE,572731,0,22792,20,9,29
1224,WONDERFUL TOWN,29830255,66,449677,16,497,513
1225,WONDERHOUSE,96031,0,5339,11,9,20
1226,WONDERLAND,4438971,52,84646,30,33,63
1227,XANADU,17126310,70,240985,49,512,561
1228,YANNI,527138,107,4925,0,5,5
1229,YOU CAN'T TAKE IT WITH YOU,13227324,83,160368,39,169,208
1230,YOU NEVER CAN TELL,1153718,0,61296,23,125,148
1231,YOU'RE A GOOD MAN CHARLIE BROWN,3630774,43,84237,14,149,163
1232,YOU'RE WELCOME AMERICA. A FINAL NIGHT WITH GEORGE W. BUSH,6723050,101,66710,18,46,64
1233,ZORBA,2470523,0,88377,0,80,80
1234,ZOYA'S APARTMENT,363761,0,22745,13,45,58
